R 1920 1080

NO ./pics/colorstone.png
SO ./pics/bluestone.png
WE ./pics/greystone.png
EA ./pics/redbrick.png

S ./pics/barrel.png

FT ./pics/mossy.png
CT ./pics/wood.png

11111111111111111111111111111
10000000001100000000000000001
10110000011100000020000010001
10010000000000000000000010001
10110000011100000000000010001
100000000011N0000111011110001
11110111111101011111011110001
11111111111111111111111111111